|,  V,  V,  V,  V,  V,  V,  V,  V,  V,  V,  V,  V,  V,  V,  V,  V,  V,  V,  V,  V,  V,  V,  V,  V,  V,  V,  V,  V,  |
|,  |,  V,  V,  V,  V,  V,  V,  V,  V,  V,  V,  V,  V,  V,  V,  V,  V,  V,  V,  V,  V,  V,  V,  V,  V,  V,  V,  |,  |
|,  |,  X,  X,  X,  X,  X,  X,  X,  X,  X,  X,  X,  X,  X,  X,  X,  X,  X,  X,  X,  X,  X,  X,  X,  X,  X,  X,  |,  |
|,  |,  X,  X,  X,  X,  X,  X,  X,  X,  X,  X,  X,  X,  X,  X,  X,  X,  X,  X,  X,  X,  X,  X,  X,  X,  X,  X,  |,  |
|,  |,  X,  X,  X,  X,  X,  X,  X,  X,  X,  X,  X,  X,  X,  X,  X,  X,  X,  X,  X,  X,  X,  X,  X,  X,  X,  X,  |,  |
|,  |,  X,  X,  X,  X,  X,  X,  X,  X,  X,  X,  X,  X,  X,  X,  X,  X,  X,  X,  X,  X,  X,  X,  X,  X,  X,  X,  |,  |
|,  |,  X,  X,  X,  X,  X,  X,  X,  X,  X,  X,  X,  X,  X,  X,  X,  X,  X,  X,  X,  X,  X,  X,  X,  X,  X,  X,  |,  |
|,  |,  X,  X,  X,  X,  X,  X,  X,  X,  X,  X,  X,  X,  X,  X,  X,  X,  X,  X,  X,  X,  X,  X,  X,  X,  X,  X,  |,  |
|,  |,  X,  X,  X,  X,  X,  X,  X,  X,  X,  X,  X,  X,  X,  X,  X,  X,  X,  X,  X,  X,  X,  X,  X,  X,  X,  X,  |,  |
|,  |,  X,  X,  X,  X,  X,  X,  X,  X,  X,  X,  X,  X,  X,  X,  X,  X,  X,  X,  X,  X,  X,  X,  X,  X,  X,  X,  |,  |
|,  |,  X,  X,  X,  X,  X,  X,  X,  X,  X,  X,  X,  X,  X,  X,  X,  X,  X,  X,  X,  X,  X,  X,  X,  X,  X,  X,  |,  |
|,  |,  X,  X,  X,  X,  X,  X,  X,  X,  X,  X,  X,  X,  X,  X,  X,  X,  X,  X,  X,  X,  X,  X,  X,  X,  X,  X,  |,  |
|,  |,  X,  X,  X,  X,  X,  X,  X,  X,  X,  X,  X,  X,  X,  X,  X,  X,  X,  X,  X,  X,  X,  X,  X,  X,  X,  X,  |,  |
|,  |,  X,  X,  X,  X,  X,  X,  X,  X,  X,  X,  X,  X,  X,  X,  X,  X,  X,  X,  X,  X,  X,  X,  X,  X,  X,  X,  |,  |
|,  |,  X,  X,  X,  X,  X,  X,  X,  X,  X,  X,  X,  X,  X,  X,  X,  X,  X,  X,  X,  X,  X,  X,  X,  X,  X,  X,  |,  |
|,  |,  X,  X,  X,  X,  X,  X,  X,  X,  X,  X,  X,  X,  X,  X,  X,  X,  X,  X,  X,  X,  X,  X,  X,  X,  X,  X,  |,  |
|,  |,  X,  X,  X,  X,  X,  X,  X,  X,  X,  X,  X,  X,  X,  X,  X,  X,  X,  X,  X,  X,  X,  X,  X,  X,  X,  X,  |,  |
|,  |,  X,  X,  X,  X,  X,  X,  X,  X,  X,  X,  X,  X,  X,  X,  X,  X,  X,  X,  X,  X,  X,  X,  X,  X,  X,  X,  |,  |
|,  |,  X,  X,  X,  X,  X,  X,  X,  X,  X,  X,  X,  X,  X,  X,  X,  X,  X,  X,  X,  X,  X,  X,  X,  X,  X,  X,  |,  |
|,  |,  X,  X,  X,  X,  X,  X,  X,  X,  X,  X,  X,  X,  X,  X,  X,  X,  X,  X,  X,  X,  X,  X,  X,  X,  X,  X,  |,  |
|,  |,  X,  X,  X,  X,  X,  X,  X,  X,  X,  X,  X,  X,  X,  X,  X,  X,  X,  X,  X,  X,  X,  X,  X,  X,  X,  X,  |,  |
|,  |,  X,  X,  X,  X,  X,  X,  X,  X,  X,  X,  X,  X,  X,  X,  X,  X,  X,  X,  X,  X,  X,  X,  X,  X,  X,  X,  |,  |
|,  |,  X,  X,  X,  X,  X,  X,  X,  X,  X,  X,  X,  X,  X,  X,  X,  X,  X,  X,  X,  X,  X,  X,  X,  X,  X,  X,  |,  |
|,  |,  X,  X,  X,  X,  X,  X,  X,  X,  X,  X,  X,  X,  X,  X,  X,  X,  X,  X,  X,  X,  X,  X,  X,  X,  X,  X,  |,  |
|,  |,  X,  X,  X,  X,  X,  X,  X,  X,  X,  X,  X,  X,  X,  X,  X,  X,  X,  X,  X,  X,  X,  X,  X,  X,  X,  X,  |,  |
|,  |,  X,  X,  X,  X,  X,  X,  X,  X,  X,  X,  X,  X,  X,  X,  X,  X,  X,  X,  X,  X,  X,  X,  X,  X,  X,  X,  |,  |
|,  |,  X,  X,  X,  X,  X,  X,  X,  X,  X,  X,  X,  X,  X,  X,  X,  X,  X,  X,  X,  X,  X,  X,  X,  X,  X,  X,  |,  |
|,  |,  X,  X,  X,  X,  X,  X,  X,  X,  X,  X,  X,  X,  X,  X,  X,  X,  X,  X,  X,  X,  X,  X,  X,  X,  X,  X,  |,  |
|,  |,  X,  X,  X,  X,  X,  X,  X,  X,  X,  X,  X,  X,  X,  X,  X,  X,  X,  X,  X,  X,  X,  X,  X,  X,  X,  X,  |,  |
|,  |,  ^,  ^,  ^,  ^,  ^,  ^,  ^,  ^,  ^,  ^,  ^,  ^,  ^,  ^,  ^,  ^,  ^,  ^,  ^,  ^,  ^,  ^,  ^,  ^,  ^,  ^,  |,  |